###############
#             #
#     ##### ###
#     ##### ###
#####E#####S###